22222222222222222222222222222222222222222
22222222222222222222222222222222222222222
22000000000000000002220000000000000000022
22022222220222222202220222222202222222022
22022222220222222202220222222202222222022
22022222220222222202220222222202222222022
22022202220222022202220222022202220222022
22022222220222222202220222222202222222022
22022222220222222202220222222202222222022
22022222220222222202220222222202222222022
22000000000000000000000000000000000000022
22022222220222022222222222022202222222022
22022222220222022222222222022202222222022
22022222220222022222222222022202222222022
22022222220222022222222222022202222222022
22022222220222022222222222022202222222022
22000000000222000002220000022200000000022
22222222220222222202220222222202222222222
22222222220222222202220222222202222222222
22222222220222222202220222222202222222222
00000002220222000000000000022202220000000
00000002220222022222322222022202220000000
00000002220222022222322222022202220000000
22222222220222022222022222022202222222222
22222222220222022222122222022202222222222
22222222220222022222022222022202222222222
00000000000000022222222222000000000000000
22222222220222022222222222022202222222222
22222222220222022222222222022202222222222
22222222220222022222222222022202222222222
00000002220222000000000000022202220000000
00000002220222022222222222022202220000000
00000002220222022222222222022202220000000
22222222220222022222222222022202222222222
22222222220222022222222222022202222222222
22222222220222022222222222022202222222222
22000000000000000002220000000000000000022
22022222220222222202220222222202222222022
22022222220222222202220222222202222222022
22022222220222222202220222222202222222022
22000002220000000000000000000002220000022
22222202220222022222222222022202220222222
22222202220222022222222222022202220222222
22222202220222022222222222022202220222222
22222202220222022222222222022202220222222
22222202220222022222222222022202220222222
22000000000222000002220000022200000000022
22022222222222222202220222222222222222022
22022222222222222202220222222222222222022
22022222222222222202220222222222222222022
22000000000000000000000000000000000000022
22222222222222222222222222222222222222222
